1 4 2 1 2 1 2 1 4 1
1 1 1 1 1 1 1 1 1 1
1 1 1 2 2 1 1 1 1 1
1 1 1 1 1 1 1 1 4 1
1 1 2 4 1 1 4 1 1 1
1 7 2 1 1 1 1 1 1 4
1 1 1 1 1 1 1 1 1 1
1 7 2 1 1 1 1 1 1 4
1 1 2 1 4 1 1 1 4 1
1 1 1 5 1 1 6 1 1 1
