2 2 2 2 2 2 2 2 2 2
2 2 2 2 2 2 2 2 2 2
2 2 2 2 2 2 2 6 6 6
2 2 2 4 4 4 6 6 4 6
2 2 2 2 3 3 4 4 4 6
2 2 2 2 3 3 4 4 4 6
2 2 2 4 4 4 6 6 4 6
2 2 2 2 2 2 2 6 6 6
2 2 2 2 2 2 2 2 2 2
2 2 2 2 2 2 2 2 2 2
