2 5 5 5 1 1 1 1 1 1
1 5 5 5 1 1 1 1 1 1
1 2 1 2 1 1 1 1 1 1
1 2 1 1 2 1 1 1 1 2
1 0 2 1 1 2 1 1 1 2
1 1 1 2 1 1 1 1 0 2
1 0 1 1 2 1 1 1 1 1
1 1 1 3 3 2 2 2 2 2
1 3 3 3 3 1 1 1 1 1
1 1 1 1 1 1 1 1 1 1
