1 1 1 1 1 1 1 1 1 1
1 -2 -2 -3 -2 -2 -3 -2 -2 1
1 -2 -2 -3 -2 -2 -3 -2 -2 1
1 -1 -1 1 -5 -5 1 -1 -1 1
1 -2 -2 1 1 1 1 -2 -2 1
1 -3 -3 1 1 1 1 -3 -3 1
1 -2 -2 1 1 1 1 -2 -2 1
1 -1 -1 1 1 1 1 -1 -1 1
1 1 1 1 7 8 1 1 1 1
1 5 1 1 1 1 1 1 6 1