1 1 1 1 4 1 1 1 1 1
7 7 1 3 3 3 3 3 3 1
7 7 1 3 3 3 3 3 3 1
1 1 1 3 1 1 1 3 3 1
1 4 1 1 1 6 1 3 3 1
1 1 1 4 1 4 1 1 1 1
1 1 1 1 1 1 1 1 1 1
1 1 1 4 1 1 7 1 4 1
1 4 1 1 1 1 7 1 1 1
1 1 1 5 1 1 1 1 1 1
